囈	呓
歸	归
馱	驮
鏜	镗
種	种
亞	亚
節	节
敍	叙
銦	铟
擔	担
瘮	瘆
癭	瘿
牀	床
紝	纴
婁	娄
併	并
緹	缇
騍	骒
燙	烫
領	领
稈	秆
鉬	钼
輛	辆
墊	垫
臠	脔
紀	纪
終	终
櫝	椟
貸	贷
余	余
獸	兽
蒔	莳
艣	橹
謬	谬
譯	译
塏	垲
癇	痫
烴	烃
矚	瞩
彞	彝
嬙	嫱
條	条
柺	拐
鉞	钺
訒	讱
誼	谊
鴨	鸭
鎡	镃
箠	棰
闋	阕
黴	霉
臘	腊
偵	侦
鐸	铎
諷	讽
銲	焊
鷁	鹢
饋	馈
鱭	鲚
余	馀
壽	寿
慶	庆
飆	飙
澩	泶
煉	炼
顳	颞
唄	呗
蕪	芜
誨	诲
鋃	锒
釧	钏
虛	虚
濛	蒙
綵	䌽
齋	斋
愾	忾
螄	蛳
麅	狍
嬸	婶
橰	槔
闐	阗
颻	飖
耬	耧
錡	锜
翹	翘
聾	聋
氈	毡
澇	涝
絞	绞
閉	闭
鉢	钵
婬	淫
瀟	潇
讚	赞
諜	谍
屆	届
撏	挦
騖	骛
鶻	鹘
餼	饩
驁	骜
穫	获
髖	髋
濱	滨
僥	侥
丑	丑
吳	吴
慾	欲
總	总
鎪	锼
鑔	镲
韤	袜
縐	绉
鑥	镥
墶	垯
攏	拢
摟	搂
綑	捆
閤	合
鰣	鲥
鳧	凫
繦	襁
隕	陨
慟	恸
頌	颂
郤	郄
鍤	锸
薔	蔷
濾	滤
幘	帻
嶔	嵚
鴬	鸴
袷	夾
縷	缕
讐	雠
緔	绱
魢	鱾
撐	撑
鏟	铲
祕	秘
膃	腽
鯷	鳀
鈸	钹
帶	带
媽	妈
懷	怀
瑲	玱
渦	涡
餞	饯
濟	济
繞	绕
擣	捣
爭	争
輟	辍
紥	扎
網	网
編	编
燶	㶶
餱	糇
鱔	鳝
塒	埘
廈	厦
陞	升
鷼	鹇
鷗	鸥
語	语
棧	栈
謖	谡
橈	桡
軤	轷
癬	癣
講	讲
餄	饸
鐃	铙
𡞵	㛟
蹺	跷
撳	揿
巹	卺
鳬	凫
蜡	蜡
駔	驵
溫	温
罌	罂
餉	饷
凟	渎
譴	谴
間	间
縋	缒
陣	阵
廟	庙
蔥	葱
蒞	莅
紕	纰
啢	唡
彥	彦
伕	夫
繭	茧
厤	历
鼉	鼍
广	广
俁	俣
鎲	镋
時	时
壈	𡒄
饒	饶
玆	兹
馮	冯
葒	荭
噓	嘘
鄲	郸
譫	谵
畝	亩
殯	殡
録	录
鯒	鲬
貼	贴
輝	辉
鬩	阋
彆	别
膩	腻
奬	奖
澁	涩
薌	芗
鱨	鲿
汙	污
蔔	卜
獻	献
甌	瓯
噚	㖊
噹	当
珮	佩
鸘	鹴
輪	轮
躒	跞
崙	仑
烏	乌
譽	誉
擺	摆
輈	辀
餶	馉
複	复
牐	闸
錙	锱
屜	屉
輯	辑
隊	队
刪	删
悵	怅
瀕	濒
癥	症
瀲	潋
禎	祯
邐	逦
鱝	鲼
堿	碱
丟	丢
嘰	叽
欽	钦
爺	爷
餛	馄
躪	躏
饌	馔
鸕	鸬
爿	丬
權	权
确	确
趙	赵
鹼	碱
屬	属
櫧	槠
軾	轼
銀	银
災	灾
藎	荩
鏢	镖
鷀	鹚
囅	冁
樅	枞
獫	猃
嚐	尝
誾	訚
頷	颔
場	场
塢	坞
驏	骣
劒	剑
氣	气
齒	齿
趕	赶
鰩	鳐
壓	压
隷	隶
瘓	痪
鄒	邹
鉤	钩
吶	呐
麴	曲
闊	阔
駙	驸
諳	谙
鐦	锎
勦	剿
唕	唣
觀	观
摣	揸
關	关
籐	藤
鄺	邝
飀	飗
纘	缵
衝	冲
躋	跻
蔞	蒌
設	设
覦	觎
穎	颖
蕘	荛
懼	惧
幫	帮
銨	铵
鳲	鸤
彙	汇
訪	访
輻	辐
偺	咱
將	将
鉸	铰
隄	堤
飣	饤
餿	馊
瞼	睑
顱	颅
蓧	莜
虧	亏
縟	缛
饈	馐
撝	㧑
蕓	芸
鮁	鲅
谿	溪
擠	挤
驂	骖
興	兴
躍	跃
戰	战
鵶	鸦
擬	拟
癱	瘫
鳾	䴓
陝	陕
縊	缢
貶	贬
審	审
朧	胧
噸	吨
塚	冢
莢	荚
顬	颥
盡	尽
長	长
訕	讪
覘	觇
坏	坏
頑	顽
攬	揽
儷	俪
鈒	钑
環	环
梟	枭
蒐	搜
颺	扬
鯤	鲲
遼	辽
畫	划
紘	纮
鰱	鲢
釓	钆
儺	傩
范	范
謁	谒
濘	泞
輕	轻
瀏	浏
鬧	闹
蘆	芦
叄	叁
幬	帱
醜	丑
湯	汤
隣	邻
楊	杨
郵	邮
奧	奥
褘	袆
聵	聩
鼴	鼹
幟	帜
壇	坛
熗	炝
獃	呆
絏	绁
饁	馌
媮	偷
灠	漤
闚	窥
談	谈
鍬	锹
誚	诮
覺	觉
鵃	鸼
鰷	鲦
賉	恤
譎	谲
託	讬
堅	坚
孃	娘
毉	医
獲	获
籢	奁
鋁	铝
鬨	哄
魴	鲂
騤	骙
詾	讻
罷	罢
謫	谪
鍀	锝
礆	硷
諦	谛
燬	毁
餕	馂
險	险
蔦	茑
騸	骟
鮌	鲧
織	织
蟎	螨
陳	陈
犛	牦
窰	窑
儂	侬
證	证
嚇	吓
閂	闩
癉	瘅
鼕	冬
蓮	莲
輅	辂
壚	垆
獮	狝
於	于
頃	顷
徑	径
標	标
杴	锨
曡	叠
綰	绾
託	托
嚶	嘤
墝	硗
豔	艳
檸	柠
戱	戯
么	么
鈷	钴
鸝	鹂
癩	癞
聯	联
憒	愦
鞝	绱
減	减
噝	咝
伙	伙
櫳	栊
垵	埯
淺	浅
軻	轲
逕	径
隻	只
麪	面
阯	址
犢	犊
箏	筝
頓	顿
誑	诳
獼	猕
緗	缃
鉋	刨
潤	润
創	创
瞞	瞒
篳	筚
餜	馃
燈	灯
捫	扪
釩	钒
蘭	兰
跼	局
鰺	鲹
蘢	茏
鰌	鳅
湧	涌
錸	铼
誕	诞
颱	台
謔	谑
鈺	钰
嚨	咙
盤	盘
篔	筼
愨	悫
嶮	崄
鉕	钷
鐒	铹
訶	诃
畢	毕
賒	赊
産	产
邁	迈
攜	携
聶	聂
擓	㧟
蓡	参
僉	佥
讞	谳
啞	哑
縧	绦
嵗	岁
鑑	鉴
雞	鸡
鋶	锍
額	额
鴕	鸵
誠	诚
豐	丰
鏷	镤
脫	脱
镟	旋
緼	缊
報	报
樸	朴
癡	痴
壠	垄
悶	闷
搗	捣
摯	挚
澤	泽
覡	觋
貟	贠
釦	扣
鎢	钨
櫪	枥
贇	赟
眾	众
鋨	锇
鵾	鹍
磯	矶
鱂	鳉
墾	垦
潔	洁
紺	绀
賀	贺
磚	砖
飠	饣
扡	扦
繆	缪
覿	觌
鋏	铗
綵	彩
纜	缆
呂	吕
參	参
賛	赞
粧	妆
潑	泼
瀋	渖
細	细
硜	硁
慳	悭
攝	摄
賅	赅
輸	输
术	术
撲	扑
驕	骄
卹	恤
啓	启
魷	鱿
愴	怆
勻	匀
嗩	唢
島	岛
亂	乱
緱	缑
躓	踬
腊	腊
訃	讣
嫿	婳
萵	莴
蘿	萝
飩	饨
鶯	莺
鯿	鳊
嚻	嚣
廬	庐
敗	败
綈	绨
鮶	鲪
爾	尔
蓽	荜
礙	碍
誹	诽
嘆	叹
擰	拧
脇	胁
潙	沩
釵	钗
偸	偷
菸	烟
蘞	蔹
懟	怼
貺	贶
這	这
鶪	䴗
賽	赛
俔	伣
嬋	婵
曠	旷
麵	面
禦	御
檯	台
砲	炮
搆	构
鰂	鲗
鏇	镟
鰍	鳅
憶	忆
釀	酿
臟	脏
齷	龌
塼	砖
儸	罗
剷	铲
菴	庵
瀨	濑
鈣	钙
禕	祎
錒	锕
鰻	鳗
鯗	鲞
闥	闼
現	现
鰨	鳎
詆	诋
囯	国
竇	窦
鵝	鹅
嗚	呜
鍔	锷
嘩	哗
瓔	璎
鈈	钚
餎	饹
耡	锄
蝸	蜗
赬	赪
鯕	鲯
姜	姜
牴	抵
騮	骝
濕	湿
儔	俦
輓	挽
醃	腌
硯	砚
勱	劢
瀧	泷
櫃	柜
週	周
殤	殇
紐	纽
礱	砻
沍	冱
準	准
适	适
镟	碹
並	并
歟	欤
諺	谚
嫻	娴
讒	谗
繕	缮
関	关
鱷	鳄
鉶	铏
電	电
鈉	钠
羨	羡
賊	贼
饊	馓
癧	疬
補	补
龕	龛
樹	树
鮺	鲝
梱	捆
違	违
戔	戋
夢	梦
禰	祢
慇	殷
嗊	唝
歡	欢
鸇	鹯
箋	笺
蠻	蛮
傴	伛
辤	辞
驘	骡
襲	袭
問	问
駐	驻
內	内
剄	刭
競	竞
餘	余
羅	罗
穌	稣
驄	骢
蘄	蕲
壼	壸
幹	干
擴	扩
嚳	喾
許	许
詢	询
鈿	钿
窮	穷
斬	斩
鬍	胡
縫	缝
牽	牵
軒	轩
采	采
鑹	镩
鬢	鬓
賦	赋
炤	照
衚	胡
鵪	鹌
壯	壮
噅	咴
漊	溇
燻	熏
舖	铺
莊	庄
鑽	钻
賓	宾
蔭	荫
鱤	鳡
軺	轺
駕	驾
縭	缡
惡	恶
踴	踊
壞	坏
鈞	钧
鋩	铓
戧	戗
薊	蓟
鏰	镚
鏡	镜
寶	宝
鑭	镧
聳	耸
鏤	镂
匯	汇
堝	埚
巒	峦
謝	谢
績	绩
蓯	苁
復	复
賬	账
氊	毡
滌	涤
种	种
誅	诛
筆	笔
殰	㱩
備	备
綸	纶
卻	却
紮	扎
繃	绷
燴	烩
驚	惊
簀	箦
剛	刚
摶	抟
齠	龆
拋	抛
產	产
鯴	鲺
傳	传
詞	词
錛	锛
崐	昆
嚮	向
憂	忧
館	馆
鹵	卤
認	认
離	离
剗	刬
媯	妫
執	执
則	则
闆	板
齪	龊
奩	奁
聹	聍
閔	闵
驌	骕
觸	触
凍	冻
詒	诒
鹺	鹾
熒	荧
瘧	疟
絅	䌹
劚	㔉
唚	吣
旂	旗
綫	线
詡	诩
喫	吃
顔	颜
誄	诔
廝	厮
堊	垩
甕	瓮
繽	缤
凜	凛
芻	刍
羋	芈
辭	辞
靦	腼
巖	岩
吒	咤
闖	闯
釔	钇
磧	碛
鞽	鞒
鉅	钜
紖	纼
蟲	虫
驀	蓦
誒	诶
陘	陉
顒	颙
盃	杯
緍	缗
鏃	镞
壙	圹
喎	㖞
繚	缭
塊	块
頁	页
廂	厢
鯧	鲳
隂	阴
車	车
霤	溜
鎮	镇
鏽	锈
濼	泺
連	连
鮎	鲇
鈕	钮
穩	稳
貰	贳
鷽	鸴
獰	狞
銅	铜
鰓	鳃
頮	颒
帳	帐
贄	贽
傑	杰
竪	竖
揚	扬
壘	垒
紲	绁
鍠	锽
絛	绦
東	东
櫱	蘖
缽	钵
黶	黡
蹕	跸
磑	硙
線	线
賕	赇
羢	绒
鮳	鲓
螘	蚁
嘽	啴
潯	浔
竈	灶
賻	赙
襖	袄
鋥	锃
錯	错
鉑	铂
緒	绪
黨	党
嬪	嫔
欒	栾
嘜	唛
軀	躯
顛	颠
閾	阈
屭	屃
鼂	鼌
樞	枢
蘚	藓
養	养
驥	骥
燐	磷
螮	䗖
嗎	吗
頇	顸
弔	吊
闢	辟
紂	纣
頂	顶
緝	缉
鈃	钘
欑	攒
鷲	鹫
紹	绍
騷	骚
繿	䍀
喒	咱
攄	摅
紓	纾
堖	垴
鍘	铡
儼	俨
廄	厩
稱	称
嚲	亸
謠	谣
厰	厂
嶠	峤
柜	柜
鋙	铻
顯	显
鏨	錾
懾	慑
靦	䩄
煩	烦
緦	缌
崗	岗
籟	籁
華	华
愛	爱
贊	赞
斂	敛
簫	箫
磣	碜
峽	峡
謀	谋
摜	掼
遠	远
顧	顾
誶	谇
極	极
奮	奋
貢	贡
煙	烟
鉦	钲
馴	驯
嚌	哜
曖	暧
馬	马
倈	俫
咼	呙
滄	沧
櫻	樱
埰	采
飥	饦
槃	盘
鯡	鲱
燄	焰
汎	泛
繈	襁
腳	脚
魎	魉
龐	庞
獨	独
擱	搁
翬	翚
蜆	蚬
銻	锑
慙	惭
闡	阐
檟	槚
藺	蔺
舘	馆
賠	赔
鎘	镉
姪	侄
軌	轨
隴	陇
冊	册
續	续
團	团
膚	肤
鮓	鲊
諱	讳
飽	饱
釙	钋
觶	觯
頤	颐
瘻	瘘
倀	伥
鶉	鹑
撿	捡
琯	管
膠	胶
約	约
轄	辖
佘	畲
慤	悫
給	给
擄	掳
鋜	镯
鑛	矿
弒	弑
酧	酬
薺	荠
匱	匮
歛	敛
璵	玙
簡	简
逕	迳
霑	沾
璿	璇
薀	蕰
夀	寿
皸	皲
恥	耻
淪	沦
闠	阓
駢	骈
賤	贱
絳	绛
嶢	峣
銓	铨
藪	薮
鶇	鸫
討	讨
艤	舣
嶼	屿
詵	诜
澀	涩
輒	辄
樓	楼
錶	表
慍	愠
濺	溅
碼	码
簾	帘
撾	挝
贈	赠
鍥	锲
稏	䅉
儀	仪
紡	纺
晉	晋
鐙	镫
瓊	琼
冪	幂
魚	鱼
嬤	嬷
勩	勚
螿	螀
諢	诨
閑	闲
攣	挛
釘	钉
獅	狮
葷	荤
鷥	鸶
籃	篮
鞀	鼗
婦	妇
嗇	啬
睜	睁
侷	局
寢	寝
專	专
蕁	荨
鈳	钶
靭	韧
喬	乔
鑕	锧
氹	凼
藥	药
鉛	铅
鄴	邺
遜	逊
鍇	锴
鉋	铇
嵐	岚
攖	撄
絢	绚
縗	缞
鮫	鲛
籬	篱
皚	皑
煱	㶽
猙	狰
贜	赃
妝	妆
嬡	嫒
鱺	鲡
搇	揿
緘	缄
嬌	娇
賡	赓
軃	亸
轔	辚
襴	襕
蓴	莼
骾	鲠
餳	饧
霛	灵
氾	泛
紗	纱
鯛	鲷
綾	绫
彜	彝
硃	朱
云	云
瀦	潴
玀	猡
槤	梿
親	亲
佇	伫
划	划
墳	坟
槼	规
潟	舄
紳	绅
築	筑
鷊	鹝
戶	户
迴	回
髩	鬓
閿	阌
槳	桨
蘀	萚
輊	轾
琿	珲
諸	诸
騎	骑
讌	燕
煬	炀
際	际
鎦	镏
們	们
淀	淀
蹤	踪
阬	坑
鶩	鹜
毿	毵
鉿	铪
竄	窜
聞	闻
蔴	麻
燿	耀
碭	砀
懇	恳
瓏	珑
魯	鲁
殻	壳
志	志
誘	诱
鉺	铒
甎	砖
縳	䌸
據	据
緻	致
竅	窍
無	无
飄	飘
縱	纵
圇	囵
殫	殚
讅	审
遞	递
嶄	崭
掛	挂
戀	恋
羶	膻
蓋	盖
鄖	郧
幣	币
躑	踯
篩	筛
颮	飑
餃	饺
龎	厐
眡	视
罰	罚
虜	虏
駱	骆
陸	陆
錈	锩
纔	才
穨	颓
鈍	钝
鎔	镕
廻	回
蠶	蚕
蹟	迹
艪	橹
鎄	锿
虫	虫
鏚	戚
鮚	鲒
銷	销
髮	发
達	达
窯	窑
譖	谮
斃	毙
鍺	锗
鮒	鲋
謊	谎
蝨	虱
浹	浃
鉻	铬
紋	纹
訢	䜣
鈴	铃
殨	㱮
軼	轶
閹	阉
鯔	鲻
濫	滥
廠	厂
盞	盏
漣	涟
攤	摊
鰐	鳄
濬	浚
鈧	钪
饞	馋
敵	敌
軟	软
瞜	䁖
齦	龈
輳	辏
須	须
崠	岽
俠	侠
圖	图
綞	缍
棗	枣
訩	讻
楨	桢
鑲	镶
誰	谁
綌	绤
劌	刿
偉	伟
慘	惨
適	适
絨	绒
齶	腭
僱	雇
擊	击
臺	台
鐳	镭
颺	飏
竊	窃
饝	馍
馹	驲
鬮	阄
瀆	渎
躊	踌
銪	铕
糶	粜
剴	剀
躰	体
鍍	镀
賂	赂
侖	仑
輭	软
鎚	锤
僨	偾
鏐	镠
嶁	嵝
櫸	榉
閃	闪
繹	绎
蔆	菱
瘞	瘗
頦	颏
卷	卷
肅	肃
誦	诵
偽	伪
鄧	邓
鬁	疬
淩	凌
撫	抚
萊	莱
貽	贻
輿	舆
髒	脏
鵮	鹐
豶	豮
贋	赝
詳	详
餓	饿
貧	贫
賞	赏
轅	辕
袞	衮
鱓	鳝
緩	缓
覜	眺
藴	蕴
薘	荙
钂	镋
軍	军
貨	货
尅	克
佣	佣
瀋	沈
喲	哟
勢	势
眎	视
溈	沩
諼	谖
琺	珐
餌	饵
詐	诈
絹	绢
檾	苘
氬	氩
麯	曲
鎩	铩
臉	脸
縴	纤
為	为
櫬	榇
駒	驹
酇	酂
鑱	镵
榲	榅
幾	几
眥	眦
痠	酸
讎	仇
煢	茕
軔	轫
釋	释
濔	沵
貪	贪
鈁	钫
檉	柽
誆	诓
飪	饪
墰	坛
倫	伦
壩	坝
悅	悦
獪	狯
盧	卢
舊	旧
諭	谕
鏍	镙
嘖	啧
鋤	锄
懺	忏
艢	樯
賔	宾
娬	妩
糞	粪
譚	谭
當	当
懍	懔
澦	滪
餒	馁
藉	借
鬦	斗
膕	腘
鵑	鹃
獱	㺍
諾	诺
閬	阆
鎣	蓥
輩	辈
鯰	鲇
鍾	钟
纊	纩
啟	启
梘	枧
儕	侪
瀇	㲿
迺	乃
霧	雾
賙	赒
瑤	瑶
議	议
叶	叶
確	确
甦	苏
豈	岂
鈽	钸
櫞	橼
彠	彟
颶	飓
億	亿
硶	碜
鷳	鹇
瀘	泸
椏	桠
巰	巯
陰	阴
腸	肠
灄	滠
鋯	锆
頏	颃
噴	喷
層	层
蠟	蜡
邏	逻
詎	讵
紙	纸
厛	厅
暉	晖
駟	驷
鮑	鲍
嚴	严
醖	酝
進	进
兩	两
謹	谨
鐐	镣
撣	掸
鈄	钭
繒	缯
蒓	莼
蛻	蜕
羥	羟
萇	苌
檢	检
飭	饬
宮	宫
鵬	鹏
躉	趸
懣	懑
鬭	斗
鑄	铸
鐝	镢
鐠	镨
輼	辒
斷	断
樁	桩
鴴	鸻
鬥	斗
邇	迩
製	制
說	说
擁	拥
測	测
貴	贵
譸	诪
鈡	钟
恆	恒
錨	锚
樷	丛
艦	舰
賰	䞐
賴	赖
据	据
蕢	蒉
鯢	鲵
較	较
緋	绯
綹	绺
錢	钱
揮	挥
縞	缟
爲	为
涖	莅
騁	骋
艸	艹
壠	垅
駮	驳
蟯	蛲
鏗	铿
鐫	镌
鍾	锺
藹	蔼
壋	垱
騂	骍
臢	臜
磽	硗
籲	吁
韌	韧
霽	霁
櫂	棹
熅	煴
擼	撸
囁	嗫
滸	浒
蟶	蛏
襬	䙓
質	质
稟	禀
鑞	镴
驃	骠
鰜	鳒
遺	遗
齧	啮
闤	阛
葤	荮
匲	奁
滬	沪
纖	纤
鶿	鹚
鮃	鲆
繰	缲
喚	唤
黌	黉
鯉	鲤
繫	系
癟	瘪
剎	刹
煥	焕
蕩	荡
鋇	钡
漿	浆
鶘	鹕
麗	丽
懕	恹
饉	馑
詩	诗
鷯	鹩
諡	谥
馳	驰
聽	听
勛	勋
繅	缫
苎	苧
鷫	鹔
張	张
碸	砜
暢	畅
璉	琏
囉	啰
夾	夹
嘯	啸
錠	锭
钜	巨
覷	觑
絃	弦
飿	饳
醫	医
釣	钓
畵	画
錏	铔
錕	锟
糰	团
願	愿
僞	伪
屨	屦
詭	诡
廳	厅
諧	谐
閒	闲
謗	谤
鵡	鹉
嗆	呛
騾	骡
漸	渐
几	几
縂	总
龜	龟
寧	宁
璦	瑷
褌	裈
鏌	镆
螞	蚂
鍼	针
讁	谪
風	风
脹	胀
劍	剑
曆	历
擋	挡
梔	栀
緲	缈
牆	墙
飇	飙
鰲	鳌
鉆	钻
踐	践
鶥	鹛
鶴	鹤
鍩	锘
塗	涂
齡	龄
謅	诌
糧	粮
凈	净
彫	雕
鰈	鲽
鳥	鸟
鷺	鹭
鍆	钔
鍊	炼
狹	狭
療	疗
驍	骁
甯	宁
視	视
載	载
綠	绿
飴	饴
開	开
纓	缨
徵	征
雲	云
鞦	秋
鶤	鹍
齜	龇
銜	衔
鮜	鲘
膁	肷
襝	裣
糢	模
綣	绻
賧	赕
惱	恼
牘	牍
戇	戆
組	组
鑣	镳
兗	兖
齗	龂
請	请
醼	燕
鱅	鳙
麽	么
啣	衔
遝	沓
氫	氢
璡	琎
裌	夹
懨	恹
鱖	鳜
訛	讹
轂	毂
轆	辘
繼	继
鈰	铈
誤	误
齟	龃
訓	训
鵓	鹁
頗	颇
騗	骗
郁	郁
飼	饲
錘	锤
瀰	弥
紬	䌷
鳩	鸠
葉	叶
櫫	橥
訣	诀
憮	怃
衹	只
綁	绑
裊	袅
蕕	莸
讕	谰
廕	荫
漬	渍
蹠	跖
顆	颗
傯	偬
係	系
徬	仿
嶧	峄
摳	抠
遙	遥
鉉	铉
劇	剧
搵	揾
潰	溃
隱	隐
飫	饫
嘵	哓
軸	轴
顏	颜
埡	垭
窪	洼
籥	钥
資	资
蹣	蹒
兌	兑
蠍	蝎
鵒	鹆
躦	躜
叢	丛
餅	饼
鈦	钛
鐧	锏
獄	狱
讎	雠
嚕	噜
渢	沨
磐	盘
籙	箓
罸	罚
譜	谱
崢	峥
鉀	钾
罈	坛
掄	抡
淨	净
貞	贞
厴	厣
矓	眬
憤	愤
壎	埙
綺	绮
覓	觅
銳	锐
閥	阀
詘	诎
夥	伙
訐	讦
諞	谝
鮮	鲜
罵	骂
氂	牦
礎	础
轡	辔
崳	嵛
囂	嚣
颼	飕
澗	涧
歐	欧
鵷	鹓
誥	诰
尷	尴
煒	炜
櫛	栉
韉	鞯
鍃	锪
鞏	巩
諛	谀
榮	荣
鎬	镐
銍	铚
轎	轿
項	项
紅	红
嚥	咽
襤	褴
譙	谯
韻	韵
瑯	琅
嬾	懒
鳳	凤
頻	频
氳	氲
謨	谟
掃	扫
郃	合
鋻	鉴
鰾	鳔
訖	讫
閶	阊
鴉	鸦
輥	辊
闌	阑
脈	脉
躂	跶
迆	迤
猻	狲
盜	盗
櫓	橹
責	责
糲	粝
辦	办
銛	铦
饢	馕
欏	椤
圍	围
瘉	愈
沒	没
緓	绬
會	会
糴	籴
巔	巅
槓	杠
蓀	荪
鈥	钬
還	还
駘	骀
癆	痨
園	园
變	变
鎧	铠
滯	滞
儲	储
湣	愍
雛	雏
囬	回
黲	黪
賜	赐
寬	宽
黿	鼋
鯰	鲶
機	机
瑉	珉
徴	征
臚	胪
紵	纻
饗	飨
鶲	鹟
郟	郏
嘗	尝
衊	蔑
倉	仓
噯	嗳
蓆	席
綳	绷
墮	堕
鸎	莺
話	话
懶	懒
韓	韩
甖	罂
羆	罴
薴	苧
銠	铑
趲	趱
鐘	钟
獎	奖
蟈	蝈
賍	赃
課	课
鋰	锂
鴝	鸲
飈	飙
潁	颍
剋	克
憑	凭
曨	昽
頊	顼
噁	恶
覰	觑
壪	塆
鶄	䴖
順	顺
軛	轭
躡	蹑
閲	阅
餚	肴
異	异
鋣	铘
葠	参
堦	阶
鈐	钤
韋	韦
臯	皋
繮	缰
摑	掴
縑	缣
緡	缗
蠣	蛎
針	针
騧	䯄
蟄	蛰
婭	娅
髕	髌
矇	蒙
曉	晓
稅	税
嶽	岳
敺	驱
鎝	𨱏
廎	庼
鎰	镒
褲	裤
鴟	鸱
鑊	镬
饜	餍
癮	瘾
痾	疴
戲	戏
擡	抬
鮭	鲑
榪	杩
鋟	锓
鋪	铺
顎	颚
鉄	铁
暈	晕
鶼	鹣
賃	赁
囑	嘱
溝	沟
灃	沣
糾	纠
飲	饮
鶡	鹖
襆	幞
騫	骞
勸	劝
凱	凯
餏	饻
攪	搅
鷖	鹥
鑼	锣
弳	弪
賁	贲
蠨	蟏
証	证
闍	阇
蔣	蒋
賵	赗
帥	帅
邊	边
后	后
閘	闸
綢	绸
簽	签
嫗	妪
價	价
繸	䍁
阪	坂
繪	绘
嫋	袅
駁	驳
脅	胁
鴰	鸹
爍	烁
濜	浕
篋	箧
贅	赘
錁	锞
罋	瓮
動	动
鹽	盐
靂	雳
殘	残
鏈	链
韞	韫
厲	厉
暱	昵
畱	留
垻	坝
瑋	玮
緞	缎
經	经
漵	溆
訴	诉
釕	钌
況	况
壺	壶
鮦	鲖
兒	儿
闃	阒
鴦	鸯
囘	回
惲	恽
憖	慭
紜	纭
過	过
釤	钐
鐓	镦
鬆	松
鯊	鲨
秈	籼
膿	脓
軫	轸
顙	颡
餵	喂
捨	舍
胜	胜
擇	择
魘	魇
殞	殒
買	买
選	选
鏘	锵
擧	举
閣	阁
餘	馀
慫	怂
銫	铯
氌	氇
誡	诫
嶗	崂
攙	搀
屍	尸
銖	铢
擻	擞
楓	枫
鎖	锁
縕	缊
鄉	乡
擯	摈
癤	疖
點	点
閩	闽
閏	闰
鉈	铊
覻	觑
鑤	刨
諉	诿
欄	栏
懞	蒙
賄	贿
毧	绒
瘂	痖
鐿	镱
讛	呓
聰	聪
滅	灭
鱧	鳢
醞	酝
鵯	鹎
麥	麦
罏	垆
籜	箨
錟	锬
礮	炮
繖	伞
鸏	鹲
擾	扰
諏	诹
懲	惩
謡	谣
檁	檩
龍	龙
驊	骅
鄶	郐
筑	筑
銹	锈
預	预
蝕	蚀
鍫	锹
粵	粤
鞉	鼗
澱	淀
狀	状
翽	翙
驫	骉
纇	颣
鮞	鲕
憊	惫
襍	杂
闕	阙
墻	墙
釅	酽
鷚	鹨
礪	砺
畫	画
礄	硚
牋	笺
讓	让
鑿	凿
飛	飞
嶇	岖
傚	效
噦	哕
噥	哝
贖	赎
鹹	咸
滲	渗
徹	彻
階	阶
驪	骊
償	偿
淶	涞
螢	萤
槍	枪
餺	馎
壟	垄
奼	姹
斗	斗
膾	脍
顓	颛
詔	诏
藶	苈
薳	䓕
簑	蓑
紿	绐
靨	靥
儐	傧
颸	飔
朴	朴
斕	斓
禮	礼
薩	萨
燒	烧
祐	佑
鋦	锔
詬	诟
頭	头
諍	诤
鏞	镛
騣	鬃
体	体
鍈	锳
貓	猫
負	负
鉅	巨
澮	浍
鐮	镰
誇	夸
蘋	苹
貲	赀
罎	坛
鴻	鸿
坰	垧
鐔	镡
豬	猪
鶊	鹒
厙	厍
絡	络
銘	铭
儸	㑩
歲	岁
壢	坜
鍚	钖
鍛	锻
灣	湾
雙	双
漁	渔
釺	钎
個	个
輜	辎
匵	椟
淥	渌
錐	锥
涇	泾
銩	铥
慚	惭
棲	栖
鴛	鸳
錄	录
廩	廪
鸚	鹦
藝	艺
蟬	蝉
縹	缥
澆	浇
臍	脐
韁	缰
覔	觅
驟	骤
嬀	妫
鋒	锋
讋	詟
處	处
辯	辩
曄	晔
党	党
學	学
劏	㓥
鰼	鳛
侶	侣
詼	诙
瑪	玛
皺	皱
濰	潍
鍁	锨
勝	胜
綐	䌼
縲	缧
閫	阃
熾	炽
緜	绵
辮	辫
絲	丝
勳	勋
員	员
欞	棂
湞	浈
綆	绠
諄	谆
勵	励
聲	声
職	职
爗	烨
筧	笕
鷴	鹇
价	价
詖	诐
強	强
棟	栋
鯫	鲰
苹	苹
腎	肾
見	见
閎	闳
緤	绁
鰮	鳁
嬭	奶
孫	孙
仆	仆
寫	写
諫	谏
賢	贤
辳	农
瘍	疡
顢	颟
釷	钍
吊	吊
賮	赆
鶺	鹡
鷿	䴙
錫	锡
螻	蝼
儈	侩
譁	哗
鎳	镍
軲	轱
勁	劲
臒	癯
褳	裢
洩	泄
禿	秃
黷	黩
喦	岩
絶	绝
頽	颓
護	护
塋	茔
燼	烬
餖	饾
燦	灿
隉	陧
雖	虽
贓	赃
閙	闹
洶	汹
脛	胫
師	师
級	级
縚	绦
脣	唇
潷	滗
熱	热
貫	贯
准	准
齎	赍
虯	虬
攩	挡
嬝	袅
馭	驭
聖	圣
國	国
饑	饥
撥	拨
艱	艰
籤	签
澠	渑
燉	炖
漲	涨
喪	丧
頜	颌
鴒	鸰
獷	犷
舉	举
鰵	鳘
鵂	鸺
鄕	乡
嶺	岭
鰏	鲾
蘇	苏
跡	迹
積	积
孿	孪
詗	诇
簹	筜
禪	禅
歷	历
貍	狸
颭	飐
瀠	潆
鬱	郁
襠	裆
醻	酬
齣	出
竝	并
鸂	㶉
僕	仆
綏	绥
苧	苎
轟	轰
隸	隶
鰉	鳇
蠱	蛊
簍	篓
傖	伧
齙	龅
髏	髅
礦	矿
儿	儿
闓	闿
敭	扬
撻	挞
趨	趋
導	导
諑	诼
懌	怿
駝	驼
贏	赢
鹼	硷
韆	千
劑	剂
鈑	钣
硨	砗
鑾	銮
姍	姗
襯	衬
驅	驱
碩	硕
鮊	鲌
靜	静
鉚	铆
悞	悮
璫	珰
櫺	棂
題	题
征	征
餡	馅
皰	疱
輞	辋
疇	畴
紱	绂
煆	煅
幺	么
灑	洒
輾	辗
齏	齑
匳	奁
厠	厕
區	区
蕎	荞
記	记
單	单
榿	桤
蕷	蓣
紇	纥
論	论
騰	腾
纏	缠
攷	考
濃	浓
檳	槟
腡	脶
識	识
訊	讯
麩	麸
紆	纡
噠	哒
鮝	鲞
鋅	锌
豎	竖
穢	秽
納	纳
醬	酱
諮	谘
醱	酦
腦	脑
詁	诂
慣	惯
餷	馇
膽	胆
來	来
著名	著名
臨	临
樑	梁
嬰	婴
筴	䇲
輔	辅
担	担
檣	樯
綉	绣
賫	赍
歿	殁
鴿	鸽
謭	谫
閽	阍
該	该
蠐	蛴
台	台
撓	挠
熲	颎
韍	韨
鋱	铽
鐺	铛
瀅	滢
衕	同
酈	郦
癘	疠
鴣	鸪
鰭	鳍
瞘	眍
鷂	鹞
繩	绳
堯	尧
藍	蓝
勗	勖
淵	渊
靆	叇
幱	襕
涂	涂
蝦	虾
裡	里
倆	俩
繢	缋
賾	赜
銣	铷
鐨	镄
閌	闶
饃	馍
應	应
鶓	鹋
尲	尴
与	与
釃	酾
纈	缬
鎸	镌
滎	荥
褻	亵
協	协
啗	啖
鯀	鲧
銑	铣
鰒	鳆
勣	绩
愷	恺
悽	凄
癢	痒
評	评
薈	荟
曏	向
緇	缁
飢	饥
灤	滦
瓚	瓒
鯁	鲠
曬	晒
貝	贝
鎇	镅
僂	偻
貿	贸
愜	惬
㠏	㟆
類	类
務	务
觝	抵
尋	寻
賚	赉
閡	阂
鉍	铋
鱉	鳖
愿	愿
奪	夺
嘍	喽
攔	拦
覯	觏
霢	霡
徠	徕
鱟	鲎
潿	涠
贐	赆
搾	榨
綽	绰
嚀	咛
萬	万
揹	背
鰁	鳈
擕	携
紉	纫
倖	幸
樣	样
銕	铁
嚦	呖
駛	驶
庫	库
駿	骏
竜	龙
嘸	呒
滻	浐
闒	阘
瞭	了
薑	姜
閻	阎
鶬	鸧
滿	满
誌	志
軋	轧
璽	玺
剝	剥
猶	犹
蝟	猬
躥	蹿
鱯	鳠
鶹	鹠
綱	纲
陽	阳
蠆	虿
蠅	蝇
緄	绲
業	业
鐵	铁
鑷	镊
鷦	鹪
釁	衅
頫	俯
譾	谫
鏵	铧
毀	毁
詰	诘
鈮	铌
睞	睐
爐	炉
鷰	燕
鳶	鸢
錦	锦
簷	檐
璣	玑
魨	鲀
玨	珏
騅	骓
實	实
灕	漓
盪	荡
渾	浑
挩	捝
瀝	沥
鰹	鲣
枴	拐
麼	么
訌	讧
鵞	鹅
殺	杀
佔	占
鏹	镪
彈	弹
倣	仿
鰥	鳏
襏	袯
頲	颋
燁	烨
礬	矾
維	维
鰳	鳓
著	着
鱣	鳣
劃	划
掙	挣
暫	暂
驗	验
腫	肿
閱	阅
餾	馏
彊	强
柵	栅
艙	舱
筍	笋
覲	觐
隨	随
儘	尽
晝	昼
韙	韪
沖	冲
觴	觞
湊	凑
飃	飘
廚	厨
燜	焖
疊	迭
訥	讷
轢	轹
縶	絷
癰	痈
緣	缘
從	从
靚	靓
鑠	铄
騌	骔
繳	缴
遲	迟
齕	龁
耮	耢
殲	歼
躕	蹰
櫨	栌
謐	谧
籖	签
鬚	须
毆	殴
耑	端
鯽	鲫
鰃	鳂
圓	圆
締	缔
蘊	蕴
硤	硖
撟	挢
譟	噪
箇	个
鍋	锅
粬	曲
槨	椁
矽	硅
齲	龋
崬	岽
漚	沤
鱘	鲟
慪	怄
篠	筱
凃	涂
顫	颤
釒	钅
儉	俭
鎂	镁
雋	隽
鎛	镈
鴞	鸮
濶	阔
譏	讥
驢	驴
鐲	镯
彎	弯
篛	箬
闔	阖
靄	霭
彿	佛
釬	焊
義	义
驦	骦
繯	缳
幗	帼
蕆	蒇
練	练
損	损
鵐	鹀
鋝	锊
覥	觍
嫵	妩
檜	桧
試	试
廡	庑
稜	棱
謎	谜
隖	坞
燭	烛
賈	贾
欖	榄
構	构
葯	药
門	门
鋮	铖
歎	叹
巋	岿
鍵	键
鈔	钞
亙	亘
魛	鱽
鵜	鹈
詫	诧
葦	苇
錆	锖
万	万
翺	翱
賣	卖
禍	祸
債	债
純	纯
蒼	苍
襪	袜
銃	铳
幀	帧
擷	撷
傷	伤
轀	辒
錇	锫
毬	球
貯	贮
錩	锠
運	运
犧	牺
規	规
訏	吁
曇	昙
嗶	哔
調	调
屓	屃
贗	赝
鎊	镑
鄔	邬
慄	栗
懽	欢
荊	荆
澐	沄
財	财
憫	悯
靉	叆
揀	拣
響	响
謾	谩
廢	废
繾	缱
轤	轳
謙	谦
屢	屡
銬	铐
穠	秾
滙	汇
囪	囱
駭	骇
厭	厌
囌	苏
瘲	疭
崑	昆
鸌	鹱
縉	缙
駡	骂
哢	咔
煇	辉
絍	纴
採	采
絕	绝
壜	坛
鯝	鲴
縣	县
灧	滟
衞	卫
憐	怜
賺	赚
蕒	荬
鈹	铍
廼	乃
慼	戚
蠔	蚝
桿	杆
換	换
糹	纟
鎵	镓
痺	痹
鄰	邻
櫚	榈
榦	干
蠑	蝾
礫	砾
頡	颉
宁	宁
饅	馒
訢	欣
犖	荦
窶	窭
緶	缏
滷	卤
黃	黄
灩	滟
術	术
譆	嘻
勞	劳
鏑	镝
體	体
鱗	鳞
极	极
駰	骃
蛺	蛱
澂	澄
爛	烂
狽	狈
飾	饰
銥	铱
輦	辇
骯	肮
歗	啸
茲	兹
後	后
綻	绽
鈅	钥
丰	丰
顴	颧
魺	鲄
軹	轵
劉	刘
錳	锰
詿	诖
簞	箪
顥	颢
獁	犸
鱒	鳟
瘋	疯
痙	痉
鸛	鹳
鋭	锐
閆	闫
鈎	钩
鈾	铀
説	说
諒	谅
鷹	鹰
棶	梾
穀	谷
峴	岘
儻	傥
溮	浉
靈	灵
騭	骘
縵	缦
頴	颕
佈	布
書	书
縈	萦
瞶	瞆
樂	乐
縯	演
儹	攒
訂	订
昇	升
闈	闱
窺	窥
轉	转
側	侧
朮	术
鷓	鹧
廣	广
薟	莶
縛	缚
釐	厘
糝	糁
淒	凄
貳	贰
唸	念
賑	赈
籩	笾
綜	综
讜	谠
頰	颊
齇	齄
瀉	泻
購	购
鄆	郓
詮	诠
鳴	鸣
樺	桦
難	难
騶	驺
綃	绡
龔	龚
瀾	澜
捲	卷
櫥	橱
嶨	峃
顰	颦
鑪	炉
譅	䜧
噲	哙
摻	掺
數	数
艷	艳
钁	镢
諶	谌
頒	颁
僅	仅
莧	苋
覎	觃
駸	骎
發	发
贛	赣
塵	尘
墜	坠
矯	矫
煖	暖
輬	辌
綿	绵
彌	弥
貙	䝙
諤	谔
訝	讶
訁	讠
檮	梼
餽	馈
僑	侨
鯪	鲮
臏	膑
監	监
懸	悬
謄	誊
賸	剩
鉗	钳
鱠	鲙
摺	折
鴷	䴕
姦	奸
䲁	鳚
緬	缅
縮	缩
孌	娈
詛	诅
嶴	岙
釗	钊
釹	钕
對	对
鮍	鲏
灝	灏
廁	厕
鸞	鸾
鎋	辖
娛	娱
攢	攒
媼	媪
嫺	娴
戯	戏
雜	杂
鷸	鹬
塹	堑
滾	滚
蘺	蓠
劊	刽
鍰	锾
販	贩
獺	獭
鵁	䴔
縝	缜
鮋	鲉
鯵	鲹
搶	抢
籪	簖
鴇	鸨
賭	赌
譌	讹
齬	龉
厂	厂
鵠	鹄
註	注
塲	场
棄	弃
櫟	栎
凴	凭
餑	饽
鶖	鹙
頹	颓
鏝	镘
羈	羁
蹌	跄
計	计
詠	咏
鰟	鳑
銼	锉
擲	掷
躚	跹
鮐	鲐
錮	锢
籠	笼
習	习
獵	猎
閈	闬
鷙	鸷
踡	蜷
鐶	镮
慴	慑
槧	椠
辟	辟
暘	旸
嘮	唠
淚	泪
緙	缂
橫	横
鰛	鳁
訟	讼
謂	谓
綯	绹
轍	辙
嚙	啮
營	营
騐	验
檔	档
鱸	鲈
岡	冈
襇	裥
鑒	鉴
糸	纟
農	农
帘	帘
緊	紧
殮	殓
聼	听
溼	湿
匭	匦
誣	诬
紛	纷
祿	禄
禱	祷
鋸	锯
棬	桊
閭	闾
瑩	莹
闞	阚
頎	颀
蕭	萧
渙	涣
瑒	玚
瘺	瘘
腖	胨
黽	黾
鑌	镔
穡	穑
篤	笃
緑	绿
褸	褛
銚	铫
頸	颈
閨	闺
琍	璃
鄭	郑
騏	骐
訦	谌
棖	枨
飈	飚
鋼	钢
脩	修
靣	面
閼	阏
禡	祃
莖	茎
號	号
檻	槛
絆	绊
鯨	鲸
紈	纨
繡	绣
鵲	鹊
薦	荐
諝	谞
韝	鞴
遊	游
綴	缀
鯖	鲭
颳	刮
鷄	鸡
鼈	鳖
鎿	镎
戩	戬
撈	捞
與	与
絀	绌
別	别
敘	叙
瘡	疮
諂	谄
鄘	墉
齔	龀
鑰	钥
媧	娲
鶚	鹗
処	处
軑	轪
灘	滩
涼	凉
挾	挟
窵	窎
決	决
讀	读
艫	舻
贔	赑
疊	叠
諗	谂
衆	众
讖	谶
態	态
絰	绖
鴆	鸩
籮	箩
掗	挜
傘	伞
橋	桥
臥	卧
鮷	鳀
稭	秸
寵	宠
憲	宪
鏇	旋
攆	撵
驤	骧
惻	恻
範	范
譭	毁
鈀	钯
夠	够
颯	飒
覬	觊
慮	虑
傭	佣
韃	鞑
鍶	锶
鯇	鲩
幃	帏
騙	骗
梲	棁
濁	浊
贍	赡
汚	污
剮	剐
嘔	呕
攛	撺
燾	焘
絝	绔
䰾	鲃
殼	壳
銱	铞
奐	奂
齊	齐
鮪	鲔
絎	绗
傢	家
衛	卫
謚	谥
詣	诣
遷	迁
緯	纬
鰠	鳋
飯	饭
謳	讴
鱈	鳕
診	诊
塤	埙
窩	窝
睏	困
裝	装
憚	惮
覈	核
鉭	钽
簣	篑
儅	当
崍	崃
傾	倾
驛	驿
鴯	鸸
鼇	鳌
潛	潜
籌	筹
虆	蔂
駑	驽
結	结
紼	绋
優	优
蟻	蚁
兇	凶
覽	览
費	费
嬈	娆
濤	涛
鐋	铴
韜	韬
劄	札
撚	捻
橢	椭
錚	铮
輇	辁
統	统
纍	累
癲	癫
溳	涢
瑣	琐
漢	汉
繙	翻
裏	里
穭	稆
囀	啭
癒	愈
鷈	䴘
搖	摇
綬	绶
蟣	虮
嶸	嵘
鋌	铤
